000000000000000000000000000000000000000000000000000000000000000000000000000
000000000000000000000000000000000000000000000000000000000000000000000000000
000000000000000003102200000000000000000000000000000000000000000000000000000
000000000002001111111100000000000000000000000000000000000000000000000000000
000000000000110000000111100200000000000000000000000000000000000000000000000
000000000020000000020000000100000000000000000000220000000000000000000000000
700000000011000200000000000000000000000002000000220000000000000000000000000
000080000000000000000000000000000200000000011110000000000000000070000000000
000000000000001100000110000000000000000010000000000000000000000089000000000
111111130000001000000011000000110001100000000000000011002203110099000011000
111111111110011200100211114441114441144444444444444411111111111111111111111
111111113200011114441111114444444444111111111111111111111111111111111111111
111111111111111444444444444444444444444444411111111111111111111111111111111
444444444444444444444444444444444444444444444444444444444444444444444444444