0000000000000000000000000000000000000000000000000000000000000000000
0000000000000000000000000000000000000000000000000000000000000000000
0000000000000000000000000000000000003022000000000000000000000000000
0000000000000000000000000000000000001000020000000000000000000000000
0000003000000000000000000000000000000020010000000000000000000000000
0000001000002200000200000000000002002010000000111000000000000000000
7000000002000002000000000000000000001000000000000000000000000000000
0000800001000003000000000200000000100000001000000000000070000000000
0000000000000011000000002220000000000000000000000000000089000000000
1111111000000010000000000000001100000000100011000000110099000011000
1111111144444410001000111100011144444444144444444444411111111111111
1111111111441114444444111144444444411111111111111111111111111111111
1111111111444444444444444444444444411111111111111111111111111111111
4444444444444444444444444444444444444444444444444444444444444444444