0000000000000000000000000000000000000000000000000000000000000000000
0000000000000000000000000000000000000000000000000000000000000000000
0000000000000000000000000000000000000000000000000000000000000000000
0000000000000000000000000000000000000000000000000000000000000000000
0000000000000000000000000000000000000000000000000000000000000000000
0000000000000000000200000000000000000000000000000000000000000000000
7000000000110002000000000000000000000000000000000000000000000000000
0000800100000000000000000000000000111110000000000000000070000000000
0000000000000011000001100000000000000000000000000000000089000000000
1111111300200010000000110000001100000000000011000000110099000011000
1111111111110110001000111144411111111111111111111111111111111111111
1111111100000111111111111144444411111111111111111111111111111111111
1111111111111114444444444444444444411111111111111111111111111111111
4444444444444444444444444444444444444444444444444444444444444444444